11111111111111111111111111111111111111111111111111111111111111111
1000000000000000000100000000000000000000C000100000000000000000001
10000000000000000001000000000000000000000000010000000000000000001
1000000000000C0000010000000000000000C0000000100000000000101100001
1000P000000000000001000000000000000000000000000000100000000001E01
10000000000000000001000000000C00000000000000000000000001011000001
1000000000000000000000000000000000C000000000000000000000000000001
11111111111111111111111111111111111111111111111111111111111111111