111111111111111111111111111111111111111111111111111111111111111111111111111111
1000000000000000000100000000000000000000C0000000000000000100000000000000000001
100000000000000000010000000000000000000000000000C00000000010000000000000000001
1000000000000C00000100000000000000000000000000000C0000000100000000000111100001
1000P00000000000000100000000000000000000000000000000000000100000000001E0100001
1000000000000000000100000000000000000000C0000000000000000000000000000101100001
1000000000000000000000000000000000C0000000000000000000000000000000000000000001
111111111111111111111111111111111111111111111111111111111111111111111111111111